NO textures/north_wall.xpm
SO textures/south_wall.xpm
WE textures/west_wall.xpm
EA textures/east_wall.xpm

F 220,100,0
C 225,30,0

    1111111111
    1100000001
11111101111101
10010001 1 101
10010001101101
11110000101101
   100N0000001
111000011111
10010011101
10000000001
11111111111