NO textures/wolfenstein_textures/wall_1.xpm
SO textures/wolfenstein_textures/wall_2.xpm
WE textures/wolfenstein_textures/wall_3.xpm
EA textures/wolfenstein_textures/wall_4.xpm

F 220,100,0
C 225,30,0

111111111111111111111111
101N00010000000000000001
101000010000000000000001
101010010000100000000001
101011110000100000000001
101000000000100000000001
101000000000100000000001
101000000000100000000001
111111111111111111111111
