NO textures/north_wall.xpm
SO textures/south_wall.xpm
WE textures/west_wall.xpm
EA textures/east_wall.xpm

F 220,100,0
C 225,30,0

111111111111111111111111
101N00010000000000000001
101000010000000000000001
101000010000100000000001
101000010000100000000001
101000000000100000000001
101000000000100000000001
101000000000100000000001
111111111111111111111111
101000010000000000000001
101000010000100000000001
101000010000100000000001
101000000000100000000001
101000000000100000000001
101000000000100000000001
111111111111111111111111
101000010000000000000001
101000010000100000000001
101000010000100000000001
101000000000100000000001
101000000000100000000001
101000000000100000000001
111111111111111111111111
101000010000000000000001
101000010000100000000001
101000010000100000000001
101000000000100000000001
101000000000100000000001
101000000000100000000001
111111111111111111111111
101000010000000000000001
101000010000100000000001
101000010000100000000001
101000000000100000000001
101000000000100000000001
101000000000100000000001
111111111111111111111111
101000010000000000000001
101000010000100000000001
101000010000100000000001
101000000000100000000001
101000000000100000000001
101000000000100000000001
111111111111111111111111
101000010000000000000001
101000010000100000000001
101000010000100000000001
101000000000100000000001
101000000000100000000001
101000000000100000000001
111111111111111111111111
101000010000000000000001
101000010000100000000001
101000010000100000000001
101000000000100000000001
101000000000100000000001
101000000000100000000001
111111111111111111111111
101000010000000000000001
101000010000100000000001
101000010000100000000001
101000000000100000000001
101000000000100000000001
101000000000100000000001
111111111111111111111111
101000010000000000000001
101000010000100000000001
101000010000100000000001
101000000000100000000001
101000000000100000000001
101000000000100000000001
111111111111111111111111
101000010000000000000001
101000010000100000000001
101000010000100000000001
101000000000100000000001
101000000000100000000001
101000000000100000000001
111111111111111111111111
101000010000000000000001
101000010000100000000001
101000010000100000000001
101000000000100000000001
101000000000100000000001
101000000000100000000001
111111111111111111111111
101000010000000000000001
101000010000100000000001
101000010000100000000001
101000000000100000000001
101000000000100000000001
101000000000100000000001
111111111111111111111111
101000010000000000000001
101000010000100000000001
101000010000100000000001
101000000000100000000001
101000000000100000000001
101000000000100000000001
111111111111111111111111
101000010000000000000001
101000010000100000000001
101000010000100000000001
101000000000100000000001
101000000000100000000001
101000000000100000000001
111111111111111111111111
101000010000000000000001
101000010000100000000001
101000010000100000000001
101000000000100000000001
101000000000100000000001
101000000000100000000001
111111111111111111111111