NO textures/north_wall.xpm
SO textures/south_wall.xpm
WE textures/west_wall.xpm
EA textures/east_wall.xpm

F 220,100,0
C 225,30,0

111111111111111111
100000000000000001
100000111111111101
1001001111111  101
1000000000001  101
10000011110011111111
10000011000000000001
10000011010011111111
1001000000001
1001101111111
1000001
1111111